ALL	All cell types
Adl	Adult
Adp	Adipocyte
Bld	Blood
Bon	Bone
Brs	Breast
CDV	Cardiovascular
CeL	Cell line
Dig	Digestive tract
EmF	Embryonic fibroblast
Emb	Embryo
Epd	Epidermis
Gon	Gonad
Kid	Kidney
Lar	Larvae
Liv	Liver
Lng	Lung
Myo	Muscle
Neu	Neural
Pan	Pancreas
Plc	Placenta
Prs	Prostate
Pup	Pupae
PSC	Pluripotent stem cell
Spl	Spleen
Utr	Uterus
YSt	Yeast strain
Oth	Others
NoD	No description
Unc	Unclassified
